NO assets/xpm/wall_1.xpm
SO assets/xpm/wall_2.xpm
WE assets/xpm/wall_4.xpm
EA assets/xpm/wall_5.xpm

F 100,50,20
C 255,130,0

        1111111111111111111111111
        1S00000000110000000000001
        1 11000001110000000000001
        10 100000000000      0001
111111111011000001110000000000001
100000000011000001110111110111111
11110111111111011100000010001
11110111111111011101010010001
11000000110101011100000010001
10000000000000001100000010001
10000000000000001101010010001
11000001110101011111011110 0111
11110111 1110101 101111010001 1
11111111 1111111 111111111111 1
