NO assets/xpm/wall_1.xpm
SO assets/xpm/wall_2.xpm
WE assets/xpm/wall_4.xpm
EA assets/xpm/wall_5.xpm

F 100,50,20
C 255,130,0

        1111111111111111111111111
        1000000000110000000000001
        1011000001110000000000001
        1001000000000000000000001
111111111011000001110000000000001
100000000011000001110111110111111
11110111111111011100000010001
11110111111111011101010010N01
11000000110101011100000010001
10000000000000001100000010001
10000000000000001101010010001
1100000111010101111101111000111
11110111 1110101 101111010001
11111111 1111111 111111111111
