NO assets/xpm/wall_1.xpm
SO assets/xpm/wall_2.xpm
WE assets/xpm/wall_4.xpm
EA assets/xpm/wall_5.xpm

F 100,50,20
C 255,130,0

        1111111111111111111111111
        1         11            1
        1 11     111            1
        1  1                    1
111111111 11     111            1
1         11     111 11111 111111
1111 111111111 111      1   1
1111 111111111 111 1 1  1   1
11      11 1 1 111      1   1
1               11      1   1
1               11 1 1  1   1
11     111 1 1 11111 1111 N 111
1111 111 111 1 1 101111 1   1
11111111 1111111 111111111111
